Timeline,Year,Cases,7-Day Average,Cumulative Cases,AsOf
5/10/2022,2022,1,0,1,Data as Reported to CDC as of 28 Jun 2023 2:00 PM EDT
5/11/2022,2022,5,0,6,Data as Reported to CDC as of 28 Jun 2023 2:00 PM EDT
5/12/2022,2022,0,0,6,Data as Reported to CDC as of 28 Jun 2023 2:00 PM EDT
5/13/2022,2022,0,0,6,Data as Reported to CDC as of 28 Jun 2023 2:00 PM EDT
5/14/2022,2022,0,0,6,Data as Reported to CDC as of 28 Jun 2023 2:00 PM EDT
5/15/2022,2022,2,0,8,Data as Reported to CDC as of 28 Jun 2023 2:00 PM EDT
5/16/2022,2022,7,2.142857075,15,Data as Reported to CDC as of 28 Jun 2023 2:00 PM EDT
5/17/2022,2022,3,2.428571463,18,Data as Reported to CDC as of 28 Jun 2023 2:00 PM EDT
5/18/2022,2022,2,2,20,Data as Reported to CDC as of 28 Jun 2023 2:00 PM EDT
5/19/2022,2022,3,2.428571463,23,Data as Reported to CDC as of 28 Jun 2023 2:00 PM EDT
5/20/2022,2022,0,2.428571463,23,Data as Reported to CDC as of 28 Jun 2023 2:00 PM EDT
5/21/2022,2022,1,2.571428537,24,Data as Reported to CDC as of 28 Jun 2023 2:00 PM EDT
5/22/2022,2022,1,2.428571463,25,Data as Reported to CDC as of 28 Jun 2023 2:00 PM EDT
5/23/2022,2022,3,1.857142806,28,Data as Reported to CDC as of 28 Jun 2023 2:00 PM EDT
5/24/2022,2022,4,2,32,Data as Reported to CDC as of 28 Jun 2023 2:00 PM EDT
5/25/2022,2022,2,2,34,Data as Reported to CDC as of 28 Jun 2023 2:00 PM EDT
5/26/2022,2022,2,1.857142806,36,Data as Reported to CDC as of 28 Jun 2023 2:00 PM EDT
5/27/2022,2022,4,2.428571463,40,Data as Reported to CDC as of 28 Jun 2023 2:00 PM EDT
5/28/2022,2022,0,2.285714388,40,Data as Reported to CDC as of 28 Jun 2023 2:00 PM EDT
5/29/2022,2022,6,3,46,Data as Reported to CDC as of 28 Jun 2023 2:00 PM EDT
5/30/2022,2022,8,3.714285612,54,Data as Reported to CDC as of 28 Jun 2023 2:00 PM EDT
5/31/2022,2022,5,3.857142925,59,Data as Reported to CDC as of 28 Jun 2023 2:00 PM EDT
6/1/2022,2022,9,4.857142925,68,Data as Reported to CDC as of 28 Jun 2023 2:00 PM EDT
6/2/2022,2022,13,6.428571224,81,Data as Reported to CDC as of 28 Jun 2023 2:00 PM EDT
6/3/2022,2022,7,6.857142925,88,Data as Reported to CDC as of 28 Jun 2023 2:00 PM EDT
6/4/2022,2022,5,7.571428776,93,Data as Reported to CDC as of 28 Jun 2023 2:00 PM EDT
6/5/2022,2022,6,7.571428776,99,Data as Reported to CDC as of 28 Jun 2023 2:00 PM EDT
6/6/2022,2022,20,9.285714149,119,Data as Reported to CDC as of 28 Jun 2023 2:00 PM EDT
6/7/2022,2022,19,11.28571415,138,Data as Reported to CDC as of 28 Jun 2023 2:00 PM EDT
6/8/2022,2022,12,11.71428585,150,Data as Reported to CDC as of 28 Jun 2023 2:00 PM EDT
6/9/2022,2022,6,10.71428585,156,Data as Reported to CDC as of 28 Jun 2023 2:00 PM EDT
6/10/2022,2022,24,13.14285755,180,Data as Reported to CDC as of 28 Jun 2023 2:00 PM EDT
6/11/2022,2022,11,14,191,Data as Reported to CDC as of 28 Jun 2023 2:00 PM EDT
6/12/2022,2022,25,16.7142849,216,Data as Reported to CDC as of 28 Jun 2023 2:00 PM EDT
6/13/2022,2022,25,17.4285717,241,Data as Reported to CDC as of 28 Jun 2023 2:00 PM EDT
6/14/2022,2022,26,18.4285717,267,Data as Reported to CDC as of 28 Jun 2023 2:00 PM EDT
6/15/2022,2022,33,21.4285717,300,Data as Reported to CDC as of 28 Jun 2023 2:00 PM EDT
6/16/2022,2022,26,24.2857151,326,Data as Reported to CDC as of 28 Jun 2023 2:00 PM EDT
6/17/2022,2022,33,25.5714283,359,Data as Reported to CDC as of 28 Jun 2023 2:00 PM EDT
6/18/2022,2022,27,27.8571434,386,Data as Reported to CDC as of 28 Jun 2023 2:00 PM EDT
6/19/2022,2022,36,29.4285717,422,Data as Reported to CDC as of 28 Jun 2023 2:00 PM EDT
6/20/2022,2022,42,31.8571434,464,Data as Reported to CDC as of 28 Jun 2023 2:00 PM EDT
6/21/2022,2022,43,34.2857132,507,Data as Reported to CDC as of 28 Jun 2023 2:00 PM EDT
6/22/2022,2022,62,38.42856979,569,Data as Reported to CDC as of 28 Jun 2023 2:00 PM EDT
6/23/2022,2022,56,42.7142868,625,Data as Reported to CDC as of 28 Jun 2023 2:00 PM EDT
6/24/2022,2022,49,45,674,Data as Reported to CDC as of 28 Jun 2023 2:00 PM EDT
6/25/2022,2022,55,49,729,Data as Reported to CDC as of 28 Jun 2023 2:00 PM EDT
6/26/2022,2022,66,53.2857132,795,Data as Reported to CDC as of 28 Jun 2023 2:00 PM EDT
6/27/2022,2022,97,61.1428566,892,Data as Reported to CDC as of 28 Jun 2023 2:00 PM EDT
6/28/2022,2022,90,67.85713959,982,Data as Reported to CDC as of 28 Jun 2023 2:00 PM EDT
6/29/2022,2022,78,70.14286041,1060,Data as Reported to CDC as of 28 Jun 2023 2:00 PM EDT
6/30/2022,2022,115,78.57142639,1175,Data as Reported to CDC as of 28 Jun 2023 2:00 PM EDT
7/1/2022,2022,138,91.2857132,1313,Data as Reported to CDC as of 28 Jun 2023 2:00 PM EDT
7/2/2022,2022,127,101.5714264,1440,Data as Reported to CDC as of 28 Jun 2023 2:00 PM EDT
7/3/2022,2022,131,110.8571396,1571,Data as Reported to CDC as of 28 Jun 2023 2:00 PM EDT
7/4/2022,2022,162,120.1428604,1733,Data as Reported to CDC as of 28 Jun 2023 2:00 PM EDT
7/5/2022,2022,184,133.5714264,1917,Data as Reported to CDC as of 28 Jun 2023 2:00 PM EDT
7/6/2022,2022,179,148,2096,Data as Reported to CDC as of 28 Jun 2023 2:00 PM EDT
7/7/2022,2022,183,157.7142792,2279,Data as Reported to CDC as of 28 Jun 2023 2:00 PM EDT
7/8/2022,2022,245,173,2524,Data as Reported to CDC as of 28 Jun 2023 2:00 PM EDT
7/9/2022,2022,192,182.2857208,2716,Data as Reported to CDC as of 28 Jun 2023 2:00 PM EDT
7/10/2022,2022,221,195.1428528,2937,Data as Reported to CDC as of 28 Jun 2023 2:00 PM EDT
7/11/2022,2022,347,221.5714264,3284,Data as Reported to CDC as of 28 Jun 2023 2:00 PM EDT
7/12/2022,2022,236,229,3520,Data as Reported to CDC as of 28 Jun 2023 2:00 PM EDT
7/13/2022,2022,277,243,3797,Data as Reported to CDC as of 28 Jun 2023 2:00 PM EDT
7/14/2022,2022,303,260.1428528,4100,Data as Reported to CDC as of 28 Jun 2023 2:00 PM EDT
7/15/2022,2022,353,275.5714417,4453,Data as Reported to CDC as of 28 Jun 2023 2:00 PM EDT
7/16/2022,2022,258,285,4711,Data as Reported to CDC as of 28 Jun 2023 2:00 PM EDT
7/17/2022,2022,248,288.8571472,4959,Data as Reported to CDC as of 28 Jun 2023 2:00 PM EDT
7/18/2022,2022,412,298.1428528,5371,Data as Reported to CDC as of 28 Jun 2023 2:00 PM EDT
7/19/2022,2022,327,311.1428528,5698,Data as Reported to CDC as of 28 Jun 2023 2:00 PM EDT
7/20/2022,2022,369,324.2857056,6067,Data as Reported to CDC as of 28 Jun 2023 2:00 PM EDT
7/21/2022,2022,335,328.8571472,6402,Data as Reported to CDC as of 28 Jun 2023 2:00 PM EDT
7/22/2022,2022,355,329.1428528,6757,Data as Reported to CDC as of 28 Jun 2023 2:00 PM EDT
7/23/2022,2022,308,336.2857056,7065,Data as Reported to CDC as of 28 Jun 2023 2:00 PM EDT
7/24/2022,2022,329,347.8571472,7394,Data as Reported to CDC as of 28 Jun 2023 2:00 PM EDT
7/25/2022,2022,517,362.8571472,7911,Data as Reported to CDC as of 28 Jun 2023 2:00 PM EDT
7/26/2022,2022,408,374.4285583,8319,Data as Reported to CDC as of 28 Jun 2023 2:00 PM EDT
7/27/2022,2022,460,387.4285583,8779,Data as Reported to CDC as of 28 Jun 2023 2:00 PM EDT
7/28/2022,2022,426,400.4285583,9205,Data as Reported to CDC as of 28 Jun 2023 2:00 PM EDT
7/29/2022,2022,456,414.8571472,9661,Data as Reported to CDC as of 28 Jun 2023 2:00 PM EDT
7/30/2022,2022,371,423.8571472,10032,Data as Reported to CDC as of 28 Jun 2023 2:00 PM EDT
7/31/2022,2022,359,428.1428528,10391,Data as Reported to CDC as of 28 Jun 2023 2:00 PM EDT
8/1/2022,2022,642,446,11033,Data as Reported to CDC as of 28 Jun 2023 2:00 PM EDT
8/2/2022,2022,475,455.5714417,11508,Data as Reported to CDC as of 28 Jun 2023 2:00 PM EDT
8/3/2022,2022,448,453.8571472,11956,Data as Reported to CDC as of 28 Jun 2023 2:00 PM EDT
8/4/2022,2022,447,456.8571472,12403,Data as Reported to CDC as of 28 Jun 2023 2:00 PM EDT
8/5/2022,2022,488,461.4285583,12891,Data as Reported to CDC as of 28 Jun 2023 2:00 PM EDT
8/6/2022,2022,388,463.8571472,13279,Data as Reported to CDC as of 28 Jun 2023 2:00 PM EDT
8/7/2022,2022,350,462.5714417,13629,Data as Reported to CDC as of 28 Jun 2023 2:00 PM EDT
8/8/2022,2022,509,443.5714417,14138,Data as Reported to CDC as of 28 Jun 2023 2:00 PM EDT
8/9/2022,2022,414,434.8571472,14552,Data as Reported to CDC as of 28 Jun 2023 2:00 PM EDT
8/10/2022,2022,472,438.2857056,15024,Data as Reported to CDC as of 28 Jun 2023 2:00 PM EDT
8/11/2022,2022,409,432.8571472,15433,Data as Reported to CDC as of 28 Jun 2023 2:00 PM EDT
8/12/2022,2022,402,420.5714417,15835,Data as Reported to CDC as of 28 Jun 2023 2:00 PM EDT
8/13/2022,2022,354,415.7142944,16189,Data as Reported to CDC as of 28 Jun 2023 2:00 PM EDT
8/14/2022,2022,311,410.1428528,16500,Data as Reported to CDC as of 28 Jun 2023 2:00 PM EDT
8/15/2022,2022,475,405.2857056,16975,Data as Reported to CDC as of 28 Jun 2023 2:00 PM EDT
8/16/2022,2022,328,393,17303,Data as Reported to CDC as of 28 Jun 2023 2:00 PM EDT
8/17/2022,2022,342,374.4285583,17645,Data as Reported to CDC as of 28 Jun 2023 2:00 PM EDT
8/18/2022,2022,405,373.8571472,18050,Data as Reported to CDC as of 28 Jun 2023 2:00 PM EDT
8/19/2022,2022,400,373.5714417,18450,Data as Reported to CDC as of 28 Jun 2023 2:00 PM EDT
8/20/2022,2022,343,372,18793,Data as Reported to CDC as of 28 Jun 2023 2:00 PM EDT
8/21/2022,2022,277,367.1428528,19070,Data as Reported to CDC as of 28 Jun 2023 2:00 PM EDT
8/22/2022,2022,349,349.1428528,19419,Data as Reported to CDC as of 28 Jun 2023 2:00 PM EDT
8/23/2022,2022,361,353.8571472,19780,Data as Reported to CDC as of 28 Jun 2023 2:00 PM EDT
8/24/2022,2022,307,348.8571472,20087,Data as Reported to CDC as of 28 Jun 2023 2:00 PM EDT
8/25/2022,2022,318,336.4285583,20405,Data as Reported to CDC as of 28 Jun 2023 2:00 PM EDT
8/26/2022,2022,318,324.7142944,20723,Data as Reported to CDC as of 28 Jun 2023 2:00 PM EDT
8/27/2022,2022,237,309.5714417,20960,Data as Reported to CDC as of 28 Jun 2023 2:00 PM EDT
8/28/2022,2022,238,304,21198,Data as Reported to CDC as of 28 Jun 2023 2:00 PM EDT
8/29/2022,2022,311,298.5714417,21509,Data as Reported to CDC as of 28 Jun 2023 2:00 PM EDT
8/30/2022,2022,268,285.2857056,21777,Data as Reported to CDC as of 28 Jun 2023 2:00 PM EDT
8/31/2022,2022,229,274.1428528,22006,Data as Reported to CDC as of 28 Jun 2023 2:00 PM EDT
9/1/2022,2022,340,277.2857056,22346,Data as Reported to CDC as of 28 Jun 2023 2:00 PM EDT
9/2/2022,2022,280,271.8571472,22626,Data as Reported to CDC as of 28 Jun 2023 2:00 PM EDT
9/3/2022,2022,194,265.7142944,22820,Data as Reported to CDC as of 28 Jun 2023 2:00 PM EDT
9/4/2022,2022,163,255,22983,Data as Reported to CDC as of 28 Jun 2023 2:00 PM EDT
9/5/2022,2022,236,244.2857208,23219,Data as Reported to CDC as of 28 Jun 2023 2:00 PM EDT
9/6/2022,2022,274,245.1428528,23493,Data as Reported to CDC as of 28 Jun 2023 2:00 PM EDT
9/7/2022,2022,229,245.1428528,23722,Data as Reported to CDC as of 28 Jun 2023 2:00 PM EDT
9/8/2022,2022,239,230.7142792,23961,Data as Reported to CDC as of 28 Jun 2023 2:00 PM EDT
9/9/2022,2022,215,221.4285736,24176,Data as Reported to CDC as of 28 Jun 2023 2:00 PM EDT
9/10/2022,2022,172,218.2857208,24348,Data as Reported to CDC as of 28 Jun 2023 2:00 PM EDT
9/11/2022,2022,107,210.2857208,24455,Data as Reported to CDC as of 28 Jun 2023 2:00 PM EDT
9/12/2022,2022,244,211.4285736,24699,Data as Reported to CDC as of 28 Jun 2023 2:00 PM EDT
9/13/2022,2022,194,200,24893,Data as Reported to CDC as of 28 Jun 2023 2:00 PM EDT
9/14/2022,2022,181,193.1428528,25074,Data as Reported to CDC as of 28 Jun 2023 2:00 PM EDT
9/15/2022,2022,183,185.1428528,25257,Data as Reported to CDC as of 28 Jun 2023 2:00 PM EDT
9/16/2022,2022,174,179.2857208,25431,Data as Reported to CDC as of 28 Jun 2023 2:00 PM EDT
9/17/2022,2022,137,174.2857208,25568,Data as Reported to CDC as of 28 Jun 2023 2:00 PM EDT
9/18/2022,2022,119,176,25687,Data as Reported to CDC as of 28 Jun 2023 2:00 PM EDT
9/19/2022,2022,137,160.7142792,25824,Data as Reported to CDC as of 28 Jun 2023 2:00 PM EDT
9/20/2022,2022,167,156.8571472,25991,Data as Reported to CDC as of 28 Jun 2023 2:00 PM EDT
9/21/2022,2022,136,150.4285736,26127,Data as Reported to CDC as of 28 Jun 2023 2:00 PM EDT
9/22/2022,2022,148,145.4285736,26275,Data as Reported to CDC as of 28 Jun 2023 2:00 PM EDT
9/23/2022,2022,117,137.2857208,26392,Data as Reported to CDC as of 28 Jun 2023 2:00 PM EDT
9/24/2022,2022,85,129.8571472,26477,Data as Reported to CDC as of 28 Jun 2023 2:00 PM EDT
9/25/2022,2022,85,125,26562,Data as Reported to CDC as of 28 Jun 2023 2:00 PM EDT
9/26/2022,2022,145,126.1428604,26707,Data as Reported to CDC as of 28 Jun 2023 2:00 PM EDT
9/27/2022,2022,107,117.5714264,26814,Data as Reported to CDC as of 28 Jun 2023 2:00 PM EDT
9/28/2022,2022,100,112.4285736,26914,Data as Reported to CDC as of 28 Jun 2023 2:00 PM EDT
9/29/2022,2022,111,107.1428604,27025,Data as Reported to CDC as of 28 Jun 2023 2:00 PM EDT
9/30/2022,2022,104,105.2857132,27129,Data as Reported to CDC as of 28 Jun 2023 2:00 PM EDT
10/1/2022,2022,85,105.2857132,27214,Data as Reported to CDC as of 28 Jun 2023 2:00 PM EDT
10/2/2022,2022,63,102.1428604,27277,Data as Reported to CDC as of 28 Jun 2023 2:00 PM EDT
10/3/2022,2022,90,94.2857132,27367,Data as Reported to CDC as of 28 Jun 2023 2:00 PM EDT
10/4/2022,2022,88,91.57142639,27455,Data as Reported to CDC as of 28 Jun 2023 2:00 PM EDT
10/5/2022,2022,85,89.42857361,27540,Data as Reported to CDC as of 28 Jun 2023 2:00 PM EDT
10/6/2022,2022,106,88.7142868,27646,Data as Reported to CDC as of 28 Jun 2023 2:00 PM EDT
10/7/2022,2022,84,85.85713959,27730,Data as Reported to CDC as of 28 Jun 2023 2:00 PM EDT
10/8/2022,2022,55,81.57142639,27785,Data as Reported to CDC as of 28 Jun 2023 2:00 PM EDT
10/9/2022,2022,72,82.85713959,27857,Data as Reported to CDC as of 28 Jun 2023 2:00 PM EDT
10/10/2022,2022,80,81.42857361,27937,Data as Reported to CDC as of 28 Jun 2023 2:00 PM EDT
10/11/2022,2022,68,78.57142639,28005,Data as Reported to CDC as of 28 Jun 2023 2:00 PM EDT
10/12/2022,2022,68,76.14286041,28073,Data as Reported to CDC as of 28 Jun 2023 2:00 PM EDT
10/13/2022,2022,68,70.7142868,28141,Data as Reported to CDC as of 28 Jun 2023 2:00 PM EDT
10/14/2022,2022,71,68.85713959,28212,Data as Reported to CDC as of 28 Jun 2023 2:00 PM EDT
10/15/2022,2022,47,67.7142868,28259,Data as Reported to CDC as of 28 Jun 2023 2:00 PM EDT
10/16/2022,2022,45,63.8571434,28304,Data as Reported to CDC as of 28 Jun 2023 2:00 PM EDT
10/17/2022,2022,61,61.1428566,28365,Data as Reported to CDC as of 28 Jun 2023 2:00 PM EDT
10/18/2022,2022,55,59.2857132,28420,Data as Reported to CDC as of 28 Jun 2023 2:00 PM EDT
10/19/2022,2022,44,55.8571434,28464,Data as Reported to CDC as of 28 Jun 2023 2:00 PM EDT
10/20/2022,2022,61,54.8571434,28525,Data as Reported to CDC as of 28 Jun 2023 2:00 PM EDT
10/21/2022,2022,56,52.7142868,28581,Data as Reported to CDC as of 28 Jun 2023 2:00 PM EDT
10/22/2022,2022,36,51.1428566,28617,Data as Reported to CDC as of 28 Jun 2023 2:00 PM EDT
10/23/2022,2022,27,48.57143021,28644,Data as Reported to CDC as of 28 Jun 2023 2:00 PM EDT
10/24/2022,2022,52,47.2857132,28696,Data as Reported to CDC as of 28 Jun 2023 2:00 PM EDT
10/25/2022,2022,43,45.57143021,28739,Data as Reported to CDC as of 28 Jun 2023 2:00 PM EDT
10/26/2022,2022,51,46.57143021,28790,Data as Reported to CDC as of 28 Jun 2023 2:00 PM EDT
10/27/2022,2022,50,45,28840,Data as Reported to CDC as of 28 Jun 2023 2:00 PM EDT
10/28/2022,2022,38,42.42856979,28878,Data as Reported to CDC as of 28 Jun 2023 2:00 PM EDT
10/29/2022,2022,29,41.42856979,28907,Data as Reported to CDC as of 28 Jun 2023 2:00 PM EDT
10/30/2022,2022,28,41.57143021,28935,Data as Reported to CDC as of 28 Jun 2023 2:00 PM EDT
10/31/2022,2022,47,40.8571434,28982,Data as Reported to CDC as of 28 Jun 2023 2:00 PM EDT
11/1/2022,2022,39,40.2857132,29021,Data as Reported to CDC as of 28 Jun 2023 2:00 PM EDT
11/2/2022,2022,41,38.8571434,29062,Data as Reported to CDC as of 28 Jun 2023 2:00 PM EDT
11/3/2022,2022,40,37.42856979,29102,Data as Reported to CDC as of 28 Jun 2023 2:00 PM EDT
11/4/2022,2022,32,36.57143021,29134,Data as Reported to CDC as of 28 Jun 2023 2:00 PM EDT
11/5/2022,2022,31,36.8571434,29165,Data as Reported to CDC as of 28 Jun 2023 2:00 PM EDT
11/6/2022,2022,29,37,29194,Data as Reported to CDC as of 28 Jun 2023 2:00 PM EDT
11/7/2022,2022,42,36.2857132,29236,Data as Reported to CDC as of 28 Jun 2023 2:00 PM EDT
11/8/2022,2022,25,34.2857132,29261,Data as Reported to CDC as of 28 Jun 2023 2:00 PM EDT
11/9/2022,2022,33,33.1428566,29294,Data as Reported to CDC as of 28 Jun 2023 2:00 PM EDT
11/10/2022,2022,29,31.5714283,29323,Data as Reported to CDC as of 28 Jun 2023 2:00 PM EDT
11/11/2022,2022,32,31.5714283,29355,Data as Reported to CDC as of 28 Jun 2023 2:00 PM EDT
11/12/2022,2022,16,29.4285717,29371,Data as Reported to CDC as of 28 Jun 2023 2:00 PM EDT
11/13/2022,2022,22,28.4285717,29393,Data as Reported to CDC as of 28 Jun 2023 2:00 PM EDT
11/14/2022,2022,36,27.5714283,29429,Data as Reported to CDC as of 28 Jun 2023 2:00 PM EDT
11/15/2022,2022,18,26.5714283,29447,Data as Reported to CDC as of 28 Jun 2023 2:00 PM EDT
11/16/2022,2022,23,25.1428566,29470,Data as Reported to CDC as of 28 Jun 2023 2:00 PM EDT
11/17/2022,2022,13,22.8571434,29483,Data as Reported to CDC as of 28 Jun 2023 2:00 PM EDT
11/18/2022,2022,31,22.7142849,29514,Data as Reported to CDC as of 28 Jun 2023 2:00 PM EDT
11/19/2022,2022,19,23.1428566,29533,Data as Reported to CDC as of 28 Jun 2023 2:00 PM EDT
11/20/2022,2022,19,22.7142849,29552,Data as Reported to CDC as of 28 Jun 2023 2:00 PM EDT
11/21/2022,2022,25,21.1428566,29577,Data as Reported to CDC as of 28 Jun 2023 2:00 PM EDT
11/22/2022,2022,17,21,29594,Data as Reported to CDC as of 28 Jun 2023 2:00 PM EDT
11/23/2022,2022,19,20.4285717,29613,Data as Reported to CDC as of 28 Jun 2023 2:00 PM EDT
11/24/2022,2022,17,21,29630,Data as Reported to CDC as of 28 Jun 2023 2:00 PM EDT
11/25/2022,2022,13,18.4285717,29643,Data as Reported to CDC as of 28 Jun 2023 2:00 PM EDT
11/26/2022,2022,14,17.7142849,29657,Data as Reported to CDC as of 28 Jun 2023 2:00 PM EDT
11/27/2022,2022,9,16.2857151,29666,Data as Reported to CDC as of 28 Jun 2023 2:00 PM EDT
11/28/2022,2022,21,15.71428585,29687,Data as Reported to CDC as of 28 Jun 2023 2:00 PM EDT
11/29/2022,2022,16,15.5714283,29703,Data as Reported to CDC as of 28 Jun 2023 2:00 PM EDT
11/30/2022,2022,14,14.85714245,29717,Data as Reported to CDC as of 28 Jun 2023 2:00 PM EDT
12/1/2022,2022,21,15.4285717,29738,Data as Reported to CDC as of 28 Jun 2023 2:00 PM EDT
12/2/2022,2022,16,15.85714245,29754,Data as Reported to CDC as of 28 Jun 2023 2:00 PM EDT
12/3/2022,2022,7,14.85714245,29761,Data as Reported to CDC as of 28 Jun 2023 2:00 PM EDT
12/4/2022,2022,11,15.14285755,29772,Data as Reported to CDC as of 28 Jun 2023 2:00 PM EDT
12/5/2022,2022,24,15.5714283,29796,Data as Reported to CDC as of 28 Jun 2023 2:00 PM EDT
12/6/2022,2022,10,14.71428585,29806,Data as Reported to CDC as of 28 Jun 2023 2:00 PM EDT
12/7/2022,2022,13,14.5714283,29819,Data as Reported to CDC as of 28 Jun 2023 2:00 PM EDT
12/8/2022,2022,16,13.85714245,29835,Data as Reported to CDC as of 28 Jun 2023 2:00 PM EDT
12/9/2022,2022,12,13.28571415,29847,Data as Reported to CDC as of 28 Jun 2023 2:00 PM EDT
12/10/2022,2022,12,14,29859,Data as Reported to CDC as of 28 Jun 2023 2:00 PM EDT
12/11/2022,2022,7,13.4285717,29866,Data as Reported to CDC as of 28 Jun 2023 2:00 PM EDT
12/12/2022,2022,16,12.28571415,29882,Data as Reported to CDC as of 28 Jun 2023 2:00 PM EDT
12/13/2022,2022,11,12.4285717,29893,Data as Reported to CDC as of 28 Jun 2023 2:00 PM EDT
12/14/2022,2022,13,12.4285717,29906,Data as Reported to CDC as of 28 Jun 2023 2:00 PM EDT
12/15/2022,2022,17,12.5714283,29923,Data as Reported to CDC as of 28 Jun 2023 2:00 PM EDT
12/16/2022,2022,17,13.28571415,29940,Data as Reported to CDC as of 28 Jun 2023 2:00 PM EDT
12/17/2022,2022,8,12.71428585,29948,Data as Reported to CDC as of 28 Jun 2023 2:00 PM EDT
12/18/2022,2022,9,13,29957,Data as Reported to CDC as of 28 Jun 2023 2:00 PM EDT
12/19/2022,2022,16,13,29973,Data as Reported to CDC as of 28 Jun 2023 2:00 PM EDT
12/20/2022,2022,12,13.14285755,29985,Data as Reported to CDC as of 28 Jun 2023 2:00 PM EDT
12/21/2022,2022,2,11.5714283,29987,Data as Reported to CDC as of 28 Jun 2023 2:00 PM EDT
12/22/2022,2022,9,10.4285717,29996,Data as Reported to CDC as of 28 Jun 2023 2:00 PM EDT
12/23/2022,2022,10,9.428571701,30006,Data as Reported to CDC as of 28 Jun 2023 2:00 PM EDT
12/24/2022,2022,5,9,30011,Data as Reported to CDC as of 28 Jun 2023 2:00 PM EDT
12/25/2022,2022,7,8.714285851,30018,Data as Reported to CDC as of 28 Jun 2023 2:00 PM EDT
12/26/2022,2022,8,7.571428776,30026,Data as Reported to CDC as of 28 Jun 2023 2:00 PM EDT
12/27/2022,2022,4,6.428571224,30030,Data as Reported to CDC as of 28 Jun 2023 2:00 PM EDT
12/28/2022,2022,6,7,30036,Data as Reported to CDC as of 28 Jun 2023 2:00 PM EDT
12/29/2022,2022,3,6.142857075,30039,Data as Reported to CDC as of 28 Jun 2023 2:00 PM EDT
12/30/2022,2022,5,5.428571224,30044,Data as Reported to CDC as of 28 Jun 2023 2:00 PM EDT
12/31/2022,2022,5,5.428571224,30049,Data as Reported to CDC as of 28 Jun 2023 2:00 PM EDT
1/1/2023,2023,11,6,30060,Data as Reported to CDC as of 28 Jun 2023 2:00 PM EDT
1/2/2023,2023,2,5.142857075,30062,Data as Reported to CDC as of 28 Jun 2023 2:00 PM EDT
1/3/2023,2023,10,6,30072,Data as Reported to CDC as of 28 Jun 2023 2:00 PM EDT
1/4/2023,2023,3,5.571428776,30075,Data as Reported to CDC as of 28 Jun 2023 2:00 PM EDT
1/5/2023,2023,9,6.428571224,30084,Data as Reported to CDC as of 28 Jun 2023 2:00 PM EDT
1/6/2023,2023,6,6.571428776,30090,Data as Reported to CDC as of 28 Jun 2023 2:00 PM EDT
1/7/2023,2023,6,6.714285851,30096,Data as Reported to CDC as of 28 Jun 2023 2:00 PM EDT
1/8/2023,2023,8,6.285714149,30104,Data as Reported to CDC as of 28 Jun 2023 2:00 PM EDT
1/9/2023,2023,7,7,30111,Data as Reported to CDC as of 28 Jun 2023 2:00 PM EDT
1/10/2023,2023,10,7,30121,Data as Reported to CDC as of 28 Jun 2023 2:00 PM EDT
1/11/2023,2023,7,7.571428776,30128,Data as Reported to CDC as of 28 Jun 2023 2:00 PM EDT
1/12/2023,2023,8,7.428571224,30136,Data as Reported to CDC as of 28 Jun 2023 2:00 PM EDT
1/13/2023,2023,7,7.571428776,30143,Data as Reported to CDC as of 28 Jun 2023 2:00 PM EDT
1/14/2023,2023,6,7.571428776,30149,Data as Reported to CDC as of 28 Jun 2023 2:00 PM EDT
1/15/2023,2023,6,7.285714149,30155,Data as Reported to CDC as of 28 Jun 2023 2:00 PM EDT
1/16/2023,2023,4,6.857142925,30159,Data as Reported to CDC as of 28 Jun 2023 2:00 PM EDT
1/17/2023,2023,2,5.714285851,30161,Data as Reported to CDC as of 28 Jun 2023 2:00 PM EDT
1/18/2023,2023,3,5.142857075,30164,Data as Reported to CDC as of 28 Jun 2023 2:00 PM EDT
1/19/2023,2023,2,4.285714149,30166,Data as Reported to CDC as of 28 Jun 2023 2:00 PM EDT
1/20/2023,2023,11,4.857142925,30177,Data as Reported to CDC as of 28 Jun 2023 2:00 PM EDT
1/21/2023,2023,5,4.714285851,30182,Data as Reported to CDC as of 28 Jun 2023 2:00 PM EDT
1/22/2023,2023,4,4.428571224,30186,Data as Reported to CDC as of 28 Jun 2023 2:00 PM EDT
1/23/2023,2023,4,4.428571224,30190,Data as Reported to CDC as of 28 Jun 2023 2:00 PM EDT
1/24/2023,2023,5,4.857142925,30195,Data as Reported to CDC as of 28 Jun 2023 2:00 PM EDT
1/25/2023,2023,7,5.428571224,30202,Data as Reported to CDC as of 28 Jun 2023 2:00 PM EDT
1/26/2023,2023,3,5.571428776,30205,Data as Reported to CDC as of 28 Jun 2023 2:00 PM EDT
1/27/2023,2023,5,4.714285851,30210,Data as Reported to CDC as of 28 Jun 2023 2:00 PM EDT
1/28/2023,2023,5,4.714285851,30215,Data as Reported to CDC as of 28 Jun 2023 2:00 PM EDT
1/29/2023,2023,3,4.571428776,30218,Data as Reported to CDC as of 28 Jun 2023 2:00 PM EDT
1/30/2023,2023,3,4.428571224,30221,Data as Reported to CDC as of 28 Jun 2023 2:00 PM EDT
1/31/2023,2023,5,4.428571224,30226,Data as Reported to CDC as of 28 Jun 2023 2:00 PM EDT
2/1/2023,2023,3,3.857142925,30229,Data as Reported to CDC as of 28 Jun 2023 2:00 PM EDT
2/2/2023,2023,7,4.428571224,30236,Data as Reported to CDC as of 28 Jun 2023 2:00 PM EDT
2/3/2023,2023,3,4.142857075,30239,Data as Reported to CDC as of 28 Jun 2023 2:00 PM EDT
2/4/2023,2023,4,4,30243,Data as Reported to CDC as of 28 Jun 2023 2:00 PM EDT
2/5/2023,2023,1,3.714285612,30244,Data as Reported to CDC as of 28 Jun 2023 2:00 PM EDT
2/6/2023,2023,1,3.428571463,30245,Data as Reported to CDC as of 28 Jun 2023 2:00 PM EDT
2/7/2023,2023,2,3,30247,Data as Reported to CDC as of 28 Jun 2023 2:00 PM EDT
2/8/2023,2023,2,2.857142925,30249,Data as Reported to CDC as of 28 Jun 2023 2:00 PM EDT
2/9/2023,2023,2,2.142857075,30251,Data as Reported to CDC as of 28 Jun 2023 2:00 PM EDT
2/10/2023,2023,4,2.285714388,30255,Data as Reported to CDC as of 28 Jun 2023 2:00 PM EDT
2/11/2023,2023,1,1.857142806,30256,Data as Reported to CDC as of 28 Jun 2023 2:00 PM EDT
2/12/2023,2023,1,1.857142806,30257,Data as Reported to CDC as of 28 Jun 2023 2:00 PM EDT
2/13/2023,2023,1,1.857142806,30258,Data as Reported to CDC as of 28 Jun 2023 2:00 PM EDT
2/14/2023,2023,2,1.857142806,30260,Data as Reported to CDC as of 28 Jun 2023 2:00 PM EDT
2/15/2023,2023,2,1.857142806,30262,Data as Reported to CDC as of 28 Jun 2023 2:00 PM EDT
2/16/2023,2023,3,2,30265,Data as Reported to CDC as of 28 Jun 2023 2:00 PM EDT
2/17/2023,2023,3,1.857142806,30268,Data as Reported to CDC as of 28 Jun 2023 2:00 PM EDT
2/18/2023,2023,2,2,30270,Data as Reported to CDC as of 28 Jun 2023 2:00 PM EDT
2/19/2023,2023,1,2,30271,Data as Reported to CDC as of 28 Jun 2023 2:00 PM EDT
2/20/2023,2023,2,2.142857075,30273,Data as Reported to CDC as of 28 Jun 2023 2:00 PM EDT
2/21/2023,2023,0,1.857142806,30273,Data as Reported to CDC as of 28 Jun 2023 2:00 PM EDT
2/22/2023,2023,2,1.857142806,30275,Data as Reported to CDC as of 28 Jun 2023 2:00 PM EDT
2/23/2023,2023,2,1.714285731,30277,Data as Reported to CDC as of 28 Jun 2023 2:00 PM EDT
2/24/2023,2023,1,1.428571463,30278,Data as Reported to CDC as of 28 Jun 2023 2:00 PM EDT
2/25/2023,2023,1,1.285714269,30279,Data as Reported to CDC as of 28 Jun 2023 2:00 PM EDT
2/26/2023,2023,4,1.714285731,30283,Data as Reported to CDC as of 28 Jun 2023 2:00 PM EDT
2/27/2023,2023,1,1.571428537,30284,Data as Reported to CDC as of 28 Jun 2023 2:00 PM EDT
2/28/2023,2023,5,2.285714388,30289,Data as Reported to CDC as of 28 Jun 2023 2:00 PM EDT
3/1/2023,2023,3,2.428571463,30292,Data as Reported to CDC as of 28 Jun 2023 2:00 PM EDT
3/2/2023,2023,1,2.285714388,30293,Data as Reported to CDC as of 28 Jun 2023 2:00 PM EDT
3/3/2023,2023,0,2.142857075,30293,Data as Reported to CDC as of 28 Jun 2023 2:00 PM EDT
3/4/2023,2023,6,2.857142925,30299,Data as Reported to CDC as of 28 Jun 2023 2:00 PM EDT
3/5/2023,2023,2,2.571428537,30301,Data as Reported to CDC as of 28 Jun 2023 2:00 PM EDT
3/6/2023,2023,0,2.428571463,30301,Data as Reported to CDC as of 28 Jun 2023 2:00 PM EDT
3/7/2023,2023,1,1.857142806,30302,Data as Reported to CDC as of 28 Jun 2023 2:00 PM EDT
3/8/2023,2023,2,1.714285731,30304,Data as Reported to CDC as of 28 Jun 2023 2:00 PM EDT
3/9/2023,2023,2,1.857142806,30306,Data as Reported to CDC as of 28 Jun 2023 2:00 PM EDT
3/10/2023,2023,4,2.428571463,30310,Data as Reported to CDC as of 28 Jun 2023 2:00 PM EDT
3/11/2023,2023,3,2,30313,Data as Reported to CDC as of 28 Jun 2023 2:00 PM EDT
3/12/2023,2023,0,1.714285731,30313,Data as Reported to CDC as of 28 Jun 2023 2:00 PM EDT
3/13/2023,2023,5,2.428571463,30318,Data as Reported to CDC as of 28 Jun 2023 2:00 PM EDT
3/14/2023,2023,2,2.571428537,30320,Data as Reported to CDC as of 28 Jun 2023 2:00 PM EDT
3/15/2023,2023,0,2.285714388,30320,Data as Reported to CDC as of 28 Jun 2023 2:00 PM EDT
3/16/2023,2023,1,2.142857075,30321,Data as Reported to CDC as of 28 Jun 2023 2:00 PM EDT
3/17/2023,2023,2,1.857142806,30323,Data as Reported to CDC as of 28 Jun 2023 2:00 PM EDT
3/18/2023,2023,1,1.571428537,30324,Data as Reported to CDC as of 28 Jun 2023 2:00 PM EDT
3/19/2023,2023,1,1.714285731,30325,Data as Reported to CDC as of 28 Jun 2023 2:00 PM EDT
3/20/2023,2023,1,1.142857194,30326,Data as Reported to CDC as of 28 Jun 2023 2:00 PM EDT
3/21/2023,2023,3,1.285714269,30329,Data as Reported to CDC as of 28 Jun 2023 2:00 PM EDT
3/22/2023,2023,0,1.285714269,30329,Data as Reported to CDC as of 28 Jun 2023 2:00 PM EDT
3/23/2023,2023,2,1.428571463,30331,Data as Reported to CDC as of 28 Jun 2023 2:00 PM EDT
3/24/2023,2023,5,1.857142806,30336,Data as Reported to CDC as of 28 Jun 2023 2:00 PM EDT
3/25/2023,2023,1,1.857142806,30337,Data as Reported to CDC as of 28 Jun 2023 2:00 PM EDT
3/26/2023,2023,2,2,30339,Data as Reported to CDC as of 28 Jun 2023 2:00 PM EDT
3/27/2023,2023,3,2.285714388,30342,Data as Reported to CDC as of 28 Jun 2023 2:00 PM EDT
3/28/2023,2023,0,1.857142806,30342,Data as Reported to CDC as of 28 Jun 2023 2:00 PM EDT
3/29/2023,2023,2,2.142857075,30344,Data as Reported to CDC as of 28 Jun 2023 2:00 PM EDT
3/30/2023,2023,10,3.285714388,30354,Data as Reported to CDC as of 28 Jun 2023 2:00 PM EDT
3/31/2023,2023,1,2.714285612,30355,Data as Reported to CDC as of 28 Jun 2023 2:00 PM EDT
4/1/2023,2023,2,2.857142925,30357,Data as Reported to CDC as of 28 Jun 2023 2:00 PM EDT
4/2/2023,2023,0,2.571428537,30357,Data as Reported to CDC as of 28 Jun 2023 2:00 PM EDT
4/3/2023,2023,3,2.571428537,30360,Data as Reported to CDC as of 28 Jun 2023 2:00 PM EDT
4/4/2023,2023,1,2.714285612,30361,Data as Reported to CDC as of 28 Jun 2023 2:00 PM EDT
4/5/2023,2023,2,2.714285612,30363,Data as Reported to CDC as of 28 Jun 2023 2:00 PM EDT
4/6/2023,2023,4,1.857142806,30367,Data as Reported to CDC as of 28 Jun 2023 2:00 PM EDT
4/7/2023,2023,0,1.714285731,30367,Data as Reported to CDC as of 28 Jun 2023 2:00 PM EDT
4/8/2023,2023,0,1.428571463,30367,Data as Reported to CDC as of 28 Jun 2023 2:00 PM EDT
4/9/2023,2023,0,1.428571463,30367,Data as Reported to CDC as of 28 Jun 2023 2:00 PM EDT
4/10/2023,2023,0,1,30367,Data as Reported to CDC as of 28 Jun 2023 2:00 PM EDT
4/11/2023,2023,0,0.857142866,30367,Data as Reported to CDC as of 28 Jun 2023 2:00 PM EDT
4/12/2023,2023,3,1,30370,Data as Reported to CDC as of 28 Jun 2023 2:00 PM EDT
4/13/2023,2023,2,0.714285731,30372,Data as Reported to CDC as of 28 Jun 2023 2:00 PM EDT
4/14/2023,2023,1,0.857142866,30373,Data as Reported to CDC as of 28 Jun 2023 2:00 PM EDT
4/15/2023,2023,3,1.285714269,30376,Data as Reported to CDC as of 28 Jun 2023 2:00 PM EDT
4/16/2023,2023,3,1.714285731,30379,Data as Reported to CDC as of 28 Jun 2023 2:00 PM EDT
4/17/2023,2023,1,1.857142806,30380,Data as Reported to CDC as of 28 Jun 2023 2:00 PM EDT
4/18/2023,2023,4,2.428571463,30384,Data as Reported to CDC as of 28 Jun 2023 2:00 PM EDT
4/19/2023,2023,2,2.285714388,30386,Data as Reported to CDC as of 28 Jun 2023 2:00 PM EDT
4/20/2023,2023,4,2.571428537,30390,Data as Reported to CDC as of 28 Jun 2023 2:00 PM EDT
4/21/2023,2023,1,2.571428537,30391,Data as Reported to CDC as of 28 Jun 2023 2:00 PM EDT
4/22/2023,2023,0,2.142857075,30391,Data as Reported to CDC as of 28 Jun 2023 2:00 PM EDT
4/23/2023,2023,2,2,30393,Data as Reported to CDC as of 28 Jun 2023 2:00 PM EDT
4/24/2023,2023,1,2,30394,Data as Reported to CDC as of 28 Jun 2023 2:00 PM EDT
4/25/2023,2023,1,1.571428537,30395,Data as Reported to CDC as of 28 Jun 2023 2:00 PM EDT
4/26/2023,2023,0,1.285714269,30395,Data as Reported to CDC as of 28 Jun 2023 2:00 PM EDT
4/27/2023,2023,1,0.857142866,30396,Data as Reported to CDC as of 28 Jun 2023 2:00 PM EDT
4/28/2023,2023,1,0.857142866,30397,Data as Reported to CDC as of 28 Jun 2023 2:00 PM EDT
4/29/2023,2023,2,1.142857194,30399,Data as Reported to CDC as of 28 Jun 2023 2:00 PM EDT
4/30/2023,2023,0,0.857142866,30399,Data as Reported to CDC as of 28 Jun 2023 2:00 PM EDT
5/1/2023,2023,5,1.428571463,30404,Data as Reported to CDC as of 28 Jun 2023 2:00 PM EDT
5/2/2023,2023,1,1.428571463,30405,Data as Reported to CDC as of 28 Jun 2023 2:00 PM EDT
5/3/2023,2023,5,2.142857075,30410,Data as Reported to CDC as of 28 Jun 2023 2:00 PM EDT
5/4/2023,2023,5,2.714285612,30415,Data as Reported to CDC as of 28 Jun 2023 2:00 PM EDT
5/5/2023,2023,2,2.857142925,30417,Data as Reported to CDC as of 28 Jun 2023 2:00 PM EDT
5/6/2023,2023,2,2.857142925,30419,Data as Reported to CDC as of 28 Jun 2023 2:00 PM EDT
5/7/2023,2023,3,3.285714388,30422,Data as Reported to CDC as of 28 Jun 2023 2:00 PM EDT
5/8/2023,2023,5,3.285714388,30427,Data as Reported to CDC as of 28 Jun 2023 2:00 PM EDT
5/9/2023,2023,4,3.714285612,30431,Data as Reported to CDC as of 28 Jun 2023 2:00 PM EDT
5/10/2023,2023,1,3.142857075,30432,Data as Reported to CDC as of 28 Jun 2023 2:00 PM EDT
5/11/2023,2023,3,2.857142925,30435,Data as Reported to CDC as of 28 Jun 2023 2:00 PM EDT
5/12/2023,2023,0,2.571428537,30435,Data as Reported to CDC as of 28 Jun 2023 2:00 PM EDT
5/13/2023,2023,3,2.714285612,30438,Data as Reported to CDC as of 28 Jun 2023 2:00 PM EDT
5/14/2023,2023,1,2.428571463,30439,Data as Reported to CDC as of 28 Jun 2023 2:00 PM EDT
5/15/2023,2023,5,2.428571463,30444,Data as Reported to CDC as of 28 Jun 2023 2:00 PM EDT
5/16/2023,2023,3,2.285714388,30447,Data as Reported to CDC as of 28 Jun 2023 2:00 PM EDT
5/17/2023,2023,1,2.285714388,30448,Data as Reported to CDC as of 28 Jun 2023 2:00 PM EDT
5/18/2023,2023,6,2.714285612,30454,Data as Reported to CDC as of 28 Jun 2023 2:00 PM EDT
5/19/2023,2023,1,2.857142925,30455,Data as Reported to CDC as of 28 Jun 2023 2:00 PM EDT
5/20/2023,2023,2,2.714285612,30457,Data as Reported to CDC as of 28 Jun 2023 2:00 PM EDT
5/21/2023,2023,0,2.571428537,30457,Data as Reported to CDC as of 28 Jun 2023 2:00 PM EDT
5/22/2023,2023,3,2.285714388,30460,Data as Reported to CDC as of 28 Jun 2023 2:00 PM EDT
5/23/2023,2023,0,1.857142806,30460,Data as Reported to CDC as of 28 Jun 2023 2:00 PM EDT
5/24/2023,2023,5,2.428571463,30465,Data as Reported to CDC as of 28 Jun 2023 2:00 PM EDT
5/25/2023,2023,4,2.142857075,30469,Data as Reported to CDC as of 28 Jun 2023 2:00 PM EDT
5/26/2023,2023,3,2.428571463,30472,Data as Reported to CDC as of 28 Jun 2023 2:00 PM EDT
5/27/2023,2023,4,2.714285612,30476,Data as Reported to CDC as of 28 Jun 2023 2:00 PM EDT
5/28/2023,2023,6,3.571428537,30482,Data as Reported to CDC as of 28 Jun 2023 2:00 PM EDT
5/29/2023,2023,2,3.428571463,30484,Data as Reported to CDC as of 28 Jun 2023 2:00 PM EDT
5/30/2023,2023,2,3.714285612,30486,Data as Reported to CDC as of 28 Jun 2023 2:00 PM EDT
5/31/2023,2023,2,3.285714388,30488,Data as Reported to CDC as of 28 Jun 2023 2:00 PM EDT
6/1/2023,2023,1,2.857142925,30489,Data as Reported to CDC as of 28 Jun 2023 2:00 PM EDT
6/2/2023,2023,3,2.857142925,30492,Data as Reported to CDC as of 28 Jun 2023 2:00 PM EDT
6/3/2023,2023,2,2.571428537,30494,Data as Reported to CDC as of 28 Jun 2023 2:00 PM EDT
6/4/2023,2023,1,1.857142806,30495,Data as Reported to CDC as of 28 Jun 2023 2:00 PM EDT
6/5/2023,2023,4,2.142857075,30499,Data as Reported to CDC as of 28 Jun 2023 2:00 PM EDT
6/6/2023,2023,3,2.285714388,30502,Data as Reported to CDC as of 28 Jun 2023 2:00 PM EDT
6/7/2023,2023,2,2.285714388,30504,Data as Reported to CDC as of 28 Jun 2023 2:00 PM EDT
6/8/2023,2023,1,2.285714388,30505,Data as Reported to CDC as of 28 Jun 2023 2:00 PM EDT
6/9/2023,2023,2,2.142857075,30507,Data as Reported to CDC as of 28 Jun 2023 2:00 PM EDT
6/10/2023,2023,2,2.142857075,30509,Data as Reported to CDC as of 28 Jun 2023 2:00 PM EDT
6/11/2023,2023,1,2.142857075,30510,Data as Reported to CDC as of 28 Jun 2023 2:00 PM EDT
6/12/2023,2023,1,1.714285731,30511,Data as Reported to CDC as of 28 Jun 2023 2:00 PM EDT
6/13/2023,2023,3,1.714285731,30514,Data as Reported to CDC as of 28 Jun 2023 2:00 PM EDT
6/14/2023,2023,2,1.714285731,30516,Data as Reported to CDC as of 28 Jun 2023 2:00 PM EDT
6/15/2023,2023,4,2.142857075,30520,Data as Reported to CDC as of 28 Jun 2023 2:00 PM EDT
6/16/2023,2023,1,2,30521,Data as Reported to CDC as of 28 Jun 2023 2:00 PM EDT
6/17/2023,2023,0,1.714285731,30521,Data as Reported to CDC as of 28 Jun 2023 2:00 PM EDT
6/18/2023,2023,1,1.714285731,30522,Data as Reported to CDC as of 28 Jun 2023 2:00 PM EDT
6/19/2023,2023,1,1.714285731,30523,Data as Reported to CDC as of 28 Jun 2023 2:00 PM EDT
6/20/2023,2023,2,1.571428537,30525,Data as Reported to CDC as of 28 Jun 2023 2:00 PM EDT
6/21/2023,2023,1,1.428571463,30526,Data as Reported to CDC as of 28 Jun 2023 2:00 PM EDT
6/22/2023,2023,1,1,30527,Data as Reported to CDC as of 28 Jun 2023 2:00 PM EDT
6/23/2023,2023,0,0.857142866,30527,Data as Reported to CDC as of 28 Jun 2023 2:00 PM EDT
6/24/2023,2023,0,0.857142866,30527,Data as Reported to CDC as of 28 Jun 2023 2:00 PM EDT
6/25/2023,2023,0,0.714285731,30527,Data as Reported to CDC as of 28 Jun 2023 2:00 PM EDT
6/26/2023,2023,0,0.571428597,30527,Data as Reported to CDC as of 28 Jun 2023 2:00 PM EDT
6/27/2023,2023,4,0.857142866,30531,Data as Reported to CDC as of 28 Jun 2023 2:00 PM EDT
6/28/2023,2023,0,0.714285731,30531,Data as Reported to CDC as of 28 Jun 2023 2:00 PM EDT
